11111111111111111111111111
1E000C00C000001000000000C1
10100101001000000000000001
10100100101010111110000001
1P0000000C00C0100000000001
100000000010111100000E0001
100000000000001100000000C1
10C00000011100000000000001
11111111111111111111111111
